P-100-600-200-25
P-300-500-150-25
F-200-400
P-600-400-100-25
F-700-300
P-900-500-150-25
F-800-400
P-500-200-300-25
F-600-100
PORT-700-50
